[[0,6,5,4,2,0],
 [0,0,0,0,3,0],
 [0,0,0,0,0,0],
 [6,0,0,3,0,0],
 [1,5,4,1,2,0],
 [0,0,0,0,0,0]]