[[0,0,0,0,0,1],
 [1,2,6,0,0,0],
 [3,0,0,0,0,0],
 [0,2,6,5,4,0],
 [0,0,0,3,0,0],
 [4,0,0,0,0,5]]