[[3,0,0,0,1,5],
 [0,0,0,0,6,0],
 [4,5,1,1,0,0],
 [0,0,1,1,0,4],
 [0,0,0,0,3,1],
 [6,2,2,0,0,0]]