[[1,1,0,0,0,0],
 [0,0,0,0,0,0],
 [6,6,3,3,0,0],
 [0,0,0,0,5,5],
 [0,4,4,0,0,0],
 [0,0,0,0,2,2]]